####################
####..##############
####..##..#...######
###..$#.$p$...######
###$..$..#.$.$#..###
###..$##.#$.$.....##
##..#..#.#...$$$..##
##.$....$..$##.#####
##.$.$.#$#..#..#####
###..###..###$.#####
###..#++++.....#####
######++++++########
#####++++###########
#####+++############
#####+++############
####################
