####################
#####........#######
#.....#...$..#p.####
#.#######$####..####
#.#....##.#..#$.++##
#.#.$.....#..#..#+##
#.#.$..#.....#$.++##
#.#..###.##.....#+##
#.###..#..#..#$.++##
#.#....#..####..#+##
#.#$...$..$..#$.++##
#....$.#.$.$.#..#+##
####.$###....#$.++##
####....$$.###++++##
####......##.#######
####################
