####################
###.......##########
###.......##########
####.####.#..#######
####.#p##....#######
###.$$$.$..$$#######
###..#.##.$..#######
###..#.##..$.#######
######..$$$.$#..####
####...##...++++####
####.#...#.#++.+####
####...#.#.##+++####
########.$..#+++####
#########...########
####################
####################
