####################
####################
####################
###########...######
#####.#.p##.$$.#####
####....$......#####
####..$..###...#####
######.#####$#######
####.$..###.++######
####.$.$.$.+++######
####....###+++######
####.$$.###+++######
####..##############
####################
####################
####################
