####################
####################
########...#.....###
#####..#.....$.$.###
#...#####.$##.#.####
#.$.##...#.##.$..###
#.$..p$$.#.##$$$.###
##.###...#.##....###
##.#...###.#####$###
##.#.....$..#++++###
#..###.##.$.#++++###
#.$...$.#...#++$+.##
#..##.$.#..##++++.##
#####...######+++###
#########....#######
####################
