####################
##p####.......#...##
#.$$...$$..$.$.+++##
#..$$$#....$..#+++##
#.$...#.$$.$$.#+++##
###...#..$....#+++##
#.....#.$.$.$.#+++##
#....######.###+++##
##.#..#..$.$..#+++##
#..##.#.$$.$.$##++##
#.++#.#..$......#+##
#.++#.#.$$$.$$$.#+##
#####.#.......#.#+##
#####.#########.#+##
#####...........#+##
####################
