####################
###########...######
#######.$..$..######
######.$..$.$.##+###
##.......$$..##++###
##..######.###++.###
###.#..#....#+++.###
##.$...#....#+++.###
##p.#$.##.####+++###
#####..$.$$..##++###
######..$.$..$+++###
######.$$..$.#..+###
######...$.$..######
###########...######
####################
####################
