####################
####################
####################
####..#..###########
####..#..#+++#######
###..$#..#+++..#####
###.$.#$$.+++..#####
###..$#..#+++.+#####
###...#.$###########
####$.......$.$.####
####..#..$$.#...####
#########..##$$p####
#########......#####
####################
####################
####################
