####################
####################
##+++...#....#...###
##+++++..$##.#.#$.##
#++++++#..$..#....##
#++++++#..#..#.#..##
#########.$..$.$..##
###.....#$##$.##$###
###...$....#.$....##
##..##.###.#..##$.##
##.$.$$.....$..$..##
##.$....$##$.#######
########..p.########
####################
####################
####################
