####################
####################
##..............####
##.#.######.....####
##.#..$.$.$.$#..####
##.#...$p$...##.####
##.#..$.$.$###+++###
##.#...$.$..##+++###
##.###$$$.$.##+++###
##.....#.##.##+++###
######...##.##+++###
##########.....#####
##########.....#####
####################
####################
####################
