####################
######.....##..#####
######...$...$.#####
########.##.$$.#####
#####...$.#....#####
#####.$$$.#.########
#####...#.#.$.######
#####..#..#..$.#####
#####.$#.$#....#####
#####...++#.########
########++.$.#p#####
#####+++++#.$#.#####
######++++#..$.#####
#######++##....#####
####################
####################
