####################
#..#################
#..#...++#++++++####
#..#.#.#####.+++####
##$#....++++++++####
#...##$######..#####
#.$.#.....######p.##
##$.#.$...######..##
#..$.#$$$##.......##
#......#....#$#$####
#.####.#$$$$$....###
#.#....$.....#...###
#.#...##........####
#.######$######.$.##
#........#....#...##
##########....######
