####################
####################
####...##..#########
###.....#..#....####
#..$.#$.#..#..+++.##
#.#.$#p$##.#.#+#+.##
#..#.#$..#....+.+.##
#.$....$.#.#.#+#+.##
#...##..##$.$.+.+.##
#.$.#...#..#$#+#+.##
##.$..$...$..$+++.##
##$.######....##..##
##..################
####################
####################
####################
