####################
#####..#############
#####....$...$.$.###
#####.$#.$.#..$..###
#####..$.$..#....###
#####.$#.#..####.###
###p#$.$.$..##...###
###....$.#$#...#.###
###...$....$.$.$.###
#######..###########
#####......#########
#####......#########
#####++++++#########
#####++++++#########
#####++++++#########
####################
