####################
#++++++...##########
#++++++...#..##...##
#++###.$....$.....##
#+++.$.$.#...##...##
#+++#$#####....#..##
###....#...#$..#$.##
###..$$.$.$..$##..##
###..$...#$#$.##$.##
#####.##.#....##..##
####..$.$.##.#######
####....$..$..######
#####...#.#...######
#########p##########
####################
####################
