####################
####################
####################
####++..#.....######
####++..#.$..$..####
####++..#$####..####
####++....p.##..####
####++..#.#..$.#####
#########.##$.$.####
######.$..$.$.$.####
######....#.....####
####################
####################
####################
####################
####################