####################
######..........####
######..#.#$$.$..###
######$.#$#..##.p###
######.##.#.$.#.####
#####...$.#$..#.####
#####...#.$...#.####
######.$.$...##.####
#####..#..##..$.####
#####....##.$$#.####
#######$$...#...####
##++++#..###########
##+#+++.############
##++++...###########
##++++...###########
####################
