####################
####################
######++..#...######
######++......######
######++..#..#######
###########..#..####
#####............###
#####..#..##..#..###
######.##..####.####
###..$..#####.#..###
###.#.$..$..#.$..###
###.p$..$...#...####
######.##.##########
######....##########
####################
####################
