####################
#########.....######
###.....#.$p$.######
###$$.#...##########
###.###++++++##...##
###...$++++++##.#.##
###.###++++++.....##
###...####.###.#$###
##..#$...#..$..#.###
##..$.$$$..#.$##.###
##...$.$.###$$.#.###
######.....$...#.###
########.###...#.###
########.....#...###
###############..###
####################
