####################
####################
##########...#######
##########.#$##..###
##########.....$.###
##########.###...###
##++++..##.$..$#####
##++++....$.$$.#####
##++++..##$..$.p####
##########..$..#####
##########.$.$..####
############.##.####
############....####
####################
####################
####################
