####################
####################
####################
#####++..#.##p######
#####++..###...#####
#####++.....$$.#####
#####++..#.#.$.#####
#####++###.#.$.#####
########.$.#$..#####
########..$#.$.#####
########.$..$..#####
########..##...#####
####################
####################
####################
####################
