####################
####################
#####..#..##########
#####.$#$.#..#######
#++.#..#..#...######
#++.#.$#$.#..$######
#+..#.....#$..#..###
#++...$#..#.$....###
#++p#..#$.#$..#..###
#++.#.$#.....$#..###
#++.#..#$$#$..#..###
#++.#.$#..#..$#$..##
#++.#..#..#...#...##
##+.####..#####...##
#####..####...######
####################
