####################
#####...#..#########
#####..$...#########
#####.#$...#########
###..$..##$...######
###..#.p.$.#.$######
###..#......$.######
####.####$##.....###
###.$#+++++#.#...###
###..$++**+.$#.#####
###..#+++++#...#####
##...###.###########
##.$$..#..##########
##..#.....##########
#######...##########
####################
