############.#######
#...#....#.###++++##
#...$$#...p..+++++##
#...#.###...#.++++##
##.##.###..#..++++##
##.$.$.....#.#.#####
##..$.$##..#......##
####.#..####.#.##.##
#..#.#$...##.#....##
#.$..$..#.##.#...###
#.#.$.$....#.#...###
#..$.##.##.#.#######
#.$$.....$$..#######
##.##.###.$..#######
##....#.#....#######
#######.############
