####################
####################
######..+..#...#####
######.#+....p.#####
######.##++#.#######
##..#.++###.....####
#.$.#+++...$.#..$.##
#....++.##..##.##.##
####$##$#.$.#...#.##
####.#....#$.$$.#.##
###..$.#.#..#.$##.##
###...............##
###..###########..##
####################
####################
####################
