####################
##########..########
######.....$########
#####.$..##.########
####p$.$.#.$..######
#######.##...$######
#####++++#$.$.######
#####++++#...$######
#####++++..$$.######
#####+++.#.$...#####
##########$.$..#####
##########...#######
##########$.########
##########..########
####################
####################
