####################
###########..#######
######.p###$.#######
####......$..#######
###..$.$$##.########
##..#$##.....#######
##.#.$.$$.#.########
##...$.#..#.$.######
####....#..$$.#...##
####.##.$.........##
#+....###..#########
#++.++#.############
#+++#+##############
#+++++##############
####################
####################
