####################
####################
####################
####################
##########.....p####
##########.$#$.#####
##########.$..$#####
###########$.$.#####
##########.$.#.#####
##++++..##.$..$..###
###+++....$..$...###
##++++..############
####################
####################
####################
####################
