####################
##############++++##
##...##.....##++++##
#..$$##..$.p##++++##
#......$$.$#..++++##
#..$.##.$$.#.#.+++##
#..$.##.$..#..++++##
##.#####.###.##+####
##...$..$.##...+..##
#.$###..#.#####.####
#...$...#.......####
#..$.#$.$.$###..####
#.$$$#.$...#.#######
#....#..$$.#########
######...###########
####################
