####################
####################
####################
#####...############
#####$..############
#####..$############
###..$.$.###########
###.#.##.###########
#...#.##.#####..++##
#.$..$..........++##
#####.###.#p##..++##
#####.....##########
####################
####################
####################
####################