####################
####################
####################
####################
#########.....p#####
#########.$#$.######
#########.$..$######
##########$.$.######
#########.$.#.######
#++++..##.$..$..####
##+++....$..$...####
#++++..#############
####################
####################
####################
####################