####################
####################
#...################
#.$..###############
##.#.#.......#######
##.#...$#$#p..#...##
#..#......$.#...$.##
#..###.#########.###
#..##.++*+++++.#.###
##.##.*+*++*+*.#.###
#.$##########.##$.##
#..$...$..$....$..##
#..#...#...#...#..##
####################
####################
####################
