####################
###...p#############
#####.$...##########
#...##....##########
#.$.#..##....#######
#.$.#..#####.#######
##.$..$....#.#######
##.$.$.###.#.#######
##.#..$..#.#.#######
##.#.#$#...#.#######
##.###...#.#.#######
#..$..####.#.#++++##
#....$....$...++#+##
####$..$#.$...++++##
#.......#..##.++++##
####################
