####################
####################
####################
###########.p#######
#####.....$..#######
#####...$##.$#######
######$#+++#.#######
######.$+++..#######
######.#+.+#.#######
######...#.#$.######
######$..$....######
######..############
####################
####################
####################
####################
