####################
####################
############..+++###
############..+++###
########......+.+###
########..##..+++###
#########.##..+++###
#########.##########
#######.$$$.########
#######..$.$.#######
###...#$.$...#...###
##p.$..$....$..$.###
#######.$$.$.#######
#######......#######
####################
####################
