####################
####...#############
####....############
####.$..####..######
####..$$.$...$######
######p.#$....######
#####..##..$.$.#####
#####.$..##.##.+####
#####..#$##$..#+####
#######...$++##+####
######....#+*+++####
######.$$.#+++++####
######..############
######..############
####################
####################
