######.....#########
#....#######..######
#...$#..#..$..#...##
#..$..$..$.#.$.$..##
##$.$...#.p#.$....##
#..$.###########.###
#.#...#+++++++#.$###
#.##..#.++++++#..###
#.#...$++++++++$.###
#.#.$.#++++.++#..###
#..$.$####$####.$###
#.$...###.$...$..###
#.$.....$.$..$....##
##.######.$.#####.##
#.........#.......##
####################
