####################
#++++++++++..+######
#++++++++++$$+#..###
###########$.#...###
#......$..$.....$.##
##.####...#..$.#..##
#......#...##..#.###
#..$#..#.##..###.###
#.$.#$###....###.###
###..$.#..#..###.###
###....$.##.#..#.###
##.$..#..$..$.$...##
##..$..$#$$$..#...##
##..#..$......######
##.p##..#..#..######
####################
