####################
####################
############..++++##
############..++++##
#....#..$.$...++++##
#.$$$#$..$.#..++++##
#..$.....$.#..++++##
#.$$.#$.$.$#########
#..$.#.....#########
##.#################
#....#....##########
#.....$...##########
#..$$#$$..p#########
#....#....##########
####################
####################
