####################
#####++++...########
#####+#+#..$.#######
#####++++#.#.p######
####.++++#..#..#####
####.....#$.##$.####
#####.###..$....####
#####$..$.$.$#..####
#####.#..$.$.##.####
#####..###..##..####
#####....##.##.#####
#####..$.#..$..#####
#######$.$...#######
#######..###########
####################
####################
