####################
#####..######...####
#...####..$.$.$.####
#.$...##.##.##..####
#...$.$.....$..$.###
###.$..##.##.....###
###.#####.#####$$.##
###$#####.p##.....##
##.$..###$###.$..###
##.$..#...###..#####
##.$$.$.#...$$.#####
##.....#...##..#####
########++.+########
#####+++++++++######
#####+++++++++######
####################
